website - The web site.
style-guide - Logo & styles.
glyph - glyphs
design-guide - common bootstrap theme and design guide for websites.
hack.g0v.tw - The hackathon portal based on hackfoldr.
summit.g0v.tw - g0v Summit 台灣零時政府高峰會
hackeditr - Hackfoldr Editor
hackfoldr-2.0 - Hackfoldr 2.0
hacktabl - Hacktabl 協作比較表格
dev-env - Dev-Env
excel-data-tool - Excel Data Tool
g0vTxT - g0v hackpad 分析器
project-hub-mockup - g0v project hub
oh-my-hub - one of g0v project hubs
projectPool - yet another g0v project hub
ideapool - yet another another g0v project hub
g0village-8bit - g0v 新手村 8bit
g0v.asia - g0v.asia
g0vphotos - g0v.photos 自己的活動自己拍
metadata-editor - g0v 專案 json 產生器 (g0v.json generator)
issue_aggregator - g0v issue 搜尋器
moc-license-center - g0v授權中心
cchelper - g0v開放授權小幫手
dev - g0v開發資訊
dkan-core - g0v零時資料中心
g0v-tour-guide - g0v導覽小精靈
axe.g0v.tw - 斧頭幫大挑戰
coVerbatim - 逐字稿工具
quick-timer - 短講計時器
goban - 零時黑板 (模組)
goban - 零時黑板 (UI)
react.vtaiwan.tw - 行政院法規線上諮詢系統 界面 2.0
dc.vtaiwan.tw - 匯流五法：線上徵詢
tw-court-parser - 台灣法院判決書可分享網址產生器
laweasyread-front - 法規亦毒氣
laweasyread - 法規亦毒氣 (API)
extract_declared_sentence - 貪污判決與查詢網站
vtaiwan.tw - 行政院法規線上諮詢系統
addressbook.parser - 政府通訊錄分析器
abroadplay - 公務人員出國考察追蹤網
taiwan-cabinet - 台灣內閣變化
twbudget - 中央政府總預算
dgbas.gov.tw - 各年度各縣市總預算視覺
ly-tel - 立委聯絡資訊
twly-voter-guide - 立委投票指南
tommy87166.github.io - 2016大選區域立委圖
soidid.github.io - 台灣各種組織不推薦立委名單
elections - 台灣選舉黃頁
partyvote2016 - 政黨票計算機
ly.g0v.tw - 國會大代誌
wp2014s_final_project - 立法卡到陰
ivod.ly.g0v.tw - 立院影城
vote2014 - 2014九合一選舉開票結果
vote2014 - 2014九合一選舉開票結果 (API)
5050 - 50天50張選舉圖表
d3visualization - 50天50張選舉圖表視覺化
mapView - 民代地圖 - 快速找民代
congress-vote-analytics - 選票成份分析系統
sunshine.cy - 金錢報
cf-viz - 金錢報 (視覺化 fuyei 版)
g0v - 金錢報 (視覺化 chungheng 版)
campaign-finance.g0v.ronny.tw - 金錢報 (資料處理區1)
tw-campaign-finance - 金錢報 (資料處理區2)
campaign-finance.g0v.ctiml.tw - 金錢報 (資料建立)
councilor-voter-guide - 議員投票指南
councilor2014.github.io - 2014台北市議員參選人
tncc - 台南市議會 議員觀測中心
ppt - 政治承諾追蹤網
twstat - 台灣隨機統計
POPonFire - 公有地大行動 Publicly Owned Property on Fire
taipei-pop - 台北市公有地資料與地圖 Publicly Owned Property - Taipei
taipei-building-has-reward - 台北市建管處建照記錄
TWDoorplates - 台灣地址門牌查詢
twgeojson - 台灣行政區視覺化
taiwan-address-lookup - 地址轉經緯度
data.g0v.ronny.tw - 政府開放資料平臺備份
local.data - 開放資料建立與普查
foundationtw - NGO list retreieved from judicial.gov.tw.
agriculture - 植物疫情與藥劑查詢系統
Real-time-Air-Quality-Map - 零時空污觀測網
env.g0v.tw - 環境儀表板
twlandsat-browse - 賽豬公上太空
cacci-opendata - 車禍熱點
roadpin - 路見不平
visualize - 國道一號電子收費價錢試算
tcbus - 台中市公車地圖
mrt - 台北捷運各站出站人數變化圖
cacci-opendata - 車禍熱點
cancer - Cancer 台灣癌症資料專案
listening - 福利請聽
ecolife.epa.gov.tw - 台灣村里家戶用電量
lead_pipes - 台灣鉛管分佈地圖
er.mohw - 全國醫院急診即時看板
visualize - 高雄地下管線地圖
drinking_water - 飲水地圖
urbancode-commission - 都委會會議紀錄資料庫
koktai - 國臺對照活用辭典
itaigi - 新台語·運動
moedict-app - 萌典網站及應用程式
moedict-data - 教育部重編國語辭典 資料檔
moedict-data-twblg - 臺灣閩南語常用詞辭典 資料檔
moedict-data-hakka - 臺灣客家語常用詞辭典 資料檔
moedict-data-csld - 中華語文知識庫 資料檔
moedict-dodo - 萌典閃卡
z0y - 零時字引
amis - 阿美語萌典
amis-safolu - 阿美語萌典 (蔡中涵版本)
amis-francais - 阿美語萌典 (潘世光版本，含切豆腐)
moe - 萌典字宙反應爐
nsc-projects - 國科會計畫補助學校金額
salary - 勞工薪資預算程式
i69 - 69K薪水工作查詢
jobhelper - 求職小幫手 (Chrome)
jobhelper-mobile - 求職小幫手
jobhelper_ff - 求職小幫手 (Firefox)
jobhelper-ie - 求職小幫手 (IE)
tisa-map - 你被服貿了嗎？
fepztw - 自經區立法辯論比較表
pcc - 開放標案
twcompany - 台灣公司登記資料
company-graph - 台灣公司關係圖
foundationtw - 台灣社團(財團)法人資料檢索
billy3321.github.io - 國民黨黨產地圖
open_crops - 農作物開放資料
farmer - 農學地圖
farmers - 小農故事
chimney_map - 固定污染源管制地圖
sheethub - 分身伐樹
ly-tel - 616 憲在關鍵三步驟「打。道。掛。」
ly-tel - 三動作護台灣
LittleBeeGeo - 小蜜蜂戰鬥地圖
boycott-helper - 網站抵制小幫手
BadDriver.tw - Bad Driver
BatDrone - BatDrone
iHelp-android - iHelp 聾通訊
petneed.me - Pet Need Me
howsfood-mockup - 好食市集
typo-resolver - 維基百科挑錯字工具
projectV - 割闌尾小遊戲
i64885 - i64885 公益律師呼叫平台
cuora - 救救食蛇龜
g8v - G8V電視牆
inLiveTW - InLiveTW
4movement - MOVEMENT 社會運動資訊平台
newsdiff - NewsDiff 官方新聞稿異動情況站
sunflower - 太陽花學運全記錄
bifrostio - 物資管理平台系統
MuscidaeFlash - 虎神快閃
twangry - 政誌
Solveissues - 站聲
ncc-complain-data - 問題電視節目查詢
news-seg - 新聞詞頻統計
newstrend.g0v.ronny.tw - 新聞趨勢統計
linkCollector - 資訊補食獸
lagnews - LagNews 腿新聞
ppllink - 公眾人物關係圖產生器
reporter - 公民記者證產生器
newshelper-extension - 新聞小幫手Chrome & Firefox 外掛
newshelper-safari - 新聞小幫手Safari 外掛
newshelper-backend - 新聞小幫手後端